8
8
920 022 020 022 022 020 022 910 
002 000 000 000 000 000 000 032
000 000 000 000 000 000 000 030 
002 000 000 001 001 000 000 032
002 000 000 001 001 000 000 032
000 000 000 000 000 000 000 030 
002 000 000 000 000 000 000 032
900 002 000 002 002 000 002 930 